//MAP CONVERTED BY dmm2tgm.py THIS HEADER COMMENT PREVENTS RECONVERSION, DO NOT REMOVE
"a" = (
/turf/template_noop,
/area/shuttle/escape)
"b" = (
/turf/open/floor/iron/dark/side,
/area/shuttle/escape)
"c" = (
/obj/effect/turf_decal/tile/blue{
	dir = 8
	},
/obj/effect/turf_decal/tile/blue{
	dir = 1
	},
/obj/structure/chair/comfy/shuttle{
	dir = 1
	},
/turf/open/floor/iron,
/area/shuttle/escape)
"e" = (
/turf/closed/wall/r_wall,
/area/shuttle/escape)
"g" = (
/obj/structure/table/reinforced,
/obj/item/storage/firstaid/morango{
	pixel_y = 12;
	pixel_x = 5
	},
/turf/open/floor/iron/dark,
/area/shuttle/escape)
"h" = (
/obj/item/kirbyplants/photosynthetic,
/turf/open/floor/iron/dark,
/area/shuttle/escape)
"i" = (
/obj/effect/turf_decal/siding/wideplating/dark{
	dir = 1
	},
/turf/open/floor/iron/dark/side{
	dir = 4
	},
/area/shuttle/escape)
"j" = (
/obj/item/kirbyplants/photosynthetic,
/obj/machinery/button/door/directional/west{
	id = "hungus";
	pixel_x = -9;
	pixel_y = 25
	},
/obj/effect/turf_decal/siding/wideplating/dark{
	dir = 8
	},
/turf/open/floor/iron/dark,
/area/shuttle/escape)
"n" = (
/obj/machinery/computer/communications,
/obj/effect/turf_decal/tile/blue{
	dir = 4
	},
/obj/effect/turf_decal/tile/blue{
	dir = 8
	},
/obj/machinery/light/small/directional/north,
/turf/open/floor/iron,
/area/shuttle/escape)
"o" = (
/obj/structure/chair/comfy/shuttle{
	dir = 1
	},
/obj/effect/turf_decal/bot{
	color = "#FF0000"
	},
/obj/effect/turf_decal/siding/wideplating/dark/corner{
	dir = 4
	},
/turf/open/floor/iron/dark,
/area/shuttle/escape)
"t" = (
/obj/structure/chair/comfy/shuttle{
	dir = 1
	},
/obj/effect/turf_decal/bot{
	color = "#FF0000"
	},
/obj/effect/turf_decal/siding/wideplating/dark/corner{
	dir = 1
	},
/turf/open/floor/iron/dark,
/area/shuttle/escape)
"u" = (
/turf/open/floor/iron/dark/side{
	dir = 4
	},
/area/shuttle/escape)
"x" = (
/obj/effect/turf_decal/delivery{
	color = "#801000"
	},
/obj/machinery/door/metal_door/south,
/turf/open/floor/iron/dark,
/area/shuttle/escape)
"y" = (
/obj/structure/lattice/catwalk,
/obj/structure/fans/tiny,
/obj/machinery/door/poddoor/shutters/preopen{
	id = "hungus"
	},
/obj/docking_port/mobile/emergency{
	dir = 1;
	name = "baluarte emergency shuttle"
	},
/turf/open/floor/plating,
/area/shuttle/escape)
"A" = (
/obj/structure/lattice/catwalk,
/obj/structure/fans/tiny,
/obj/machinery/door/poddoor/shutters/preopen{
	id = "hungus"
	},
/turf/open/floor/plating,
/area/shuttle/escape)
"B" = (
/obj/machinery/door/metal_door/south,
/obj/effect/turf_decal/siding/wideplating/dark,
/turf/open/floor/iron,
/area/shuttle/escape)
"C" = (
/turf/open/floor/iron/dark/side{
	dir = 8
	},
/area/shuttle/escape)
"E" = (
/obj/effect/turf_decal/siding/wideplating/dark{
	dir = 1
	},
/turf/open/floor/iron/dark/side{
	dir = 8
	},
/area/shuttle/escape)
"F" = (
/obj/machinery/computer/emergency_shuttle,
/obj/effect/turf_decal/tile/blue{
	dir = 1
	},
/obj/effect/turf_decal/tile/blue,
/obj/machinery/light/small/directional/north,
/turf/open/floor/iron,
/area/shuttle/escape)
"H" = (
/obj/machinery/door/metal_door/north,
/obj/effect/turf_decal/siding/wideplating/dark,
/turf/open/floor/iron,
/area/shuttle/escape)
"I" = (
/obj/effect/turf_decal/tile/red/anticorner{
	dir = 1
	},
/turf/open/floor/iron/dark/side{
	dir = 9
	},
/area/shuttle/escape)
"J" = (
/obj/effect/turf_decal/tile/blue,
/obj/effect/turf_decal/tile/blue{
	dir = 4
	},
/obj/structure/chair/comfy/shuttle{
	dir = 1
	},
/turf/open/floor/iron,
/area/shuttle/escape)
"K" = (
/obj/effect/turf_decal/tile/red/half{
	dir = 8
	},
/turf/open/floor/iron/dark/side{
	dir = 8
	},
/area/shuttle/escape)
"L" = (
/obj/item/kirbyplants/photosynthetic,
/obj/effect/turf_decal/siding/wideplating/dark{
	dir = 4
	},
/turf/open/floor/iron/dark,
/area/shuttle/escape)
"M" = (
/obj/structure/chair/comfy/shuttle{
	dir = 1
	},
/obj/effect/turf_decal/bot{
	color = "#FF0000"
	},
/turf/open/floor/iron/dark,
/area/shuttle/escape)
"N" = (
/obj/structure/lattice,
/turf/open/floor/plating,
/area/shuttle/escape)
"O" = (
/obj/effect/turf_decal/delivery{
	color = "#801000"
	},
/obj/machinery/door/metal_door/north,
/turf/open/floor/iron/dark,
/area/shuttle/escape)
"P" = (
/obj/structure/chair/comfy/shuttle{
	dir = 1
	},
/obj/effect/turf_decal/bot{
	color = "#FF0000"
	},
/turf/open/floor/iron/dark/side,
/area/shuttle/escape)
"S" = (
/obj/effect/turf_decal/tile/red/half{
	dir = 4
	},
/turf/open/floor/iron/dark/side{
	dir = 4
	},
/area/shuttle/escape)
"T" = (
/obj/effect/spawner/structure/window/reinforced,
/turf/open/floor/low_wall/reinforced,
/area/shuttle/escape)
"V" = (
/turf/open/floor/iron/dark,
/area/shuttle/escape)
"X" = (
/obj/effect/turf_decal/tile/red/anticorner{
	dir = 4
	},
/turf/open/floor/iron/dark/side{
	dir = 5
	},
/area/shuttle/escape)

(1,1,1) = {"
a
a
a
e
e
T
T
e
T
T
e
e
a
a
"}
(2,1,1) = {"
e
e
e
e
L
o
M
V
P
M
h
e
e
a
"}
(3,1,1) = {"
e
F
c
B
N
i
u
u
b
I
K
x
A
a
"}
(4,1,1) = {"
e
n
J
H
N
E
C
C
b
X
S
O
y
a
"}
(5,1,1) = {"
e
e
e
e
j
t
M
g
P
M
h
e
e
a
"}
(6,1,1) = {"
a
a
a
e
e
T
T
e
T
T
e
e
a
a
"}
