"aG" = (/obj/machinery/button/door/directional/west{pixel_y = -10},/obj/effect/turf_decal/siding/wideplating/dark{dir = 9},/obj/machinery/light/small/directional/west,/turf/open/floor/iron,/area/shuttle/escape)
"bw" = (/obj/structure/extinguisher_cabinet/directional/east,/obj/machinery/computer/communications{dir = 8},/obj/effect/turf_decal/tile/blue,/obj/effect/turf_decal/tile/blue{dir = 4},/obj/effect/turf_decal/tile/blue{dir = 1},/turf/open/floor/iron,/area/shuttle/escape)
"bH" = (/obj/effect/turf_decal/siding/wideplating/dark{dir = 8},/obj/effect/turf_decal/tile/blue{dir = 8},/obj/effect/turf_decal/tile/blue{dir = 1},/turf/open/floor/iron,/area/shuttle/escape)
"cy" = (/obj/machinery/requests_console{pixel_y = 32},/turf/open/floor/iron/dark/side,/area/shuttle/escape)
"ep" = (/obj/effect/turf_decal/siding/wideplating/dark{dir = 1},/obj/structure/railing{dir = 1},/obj/item/kirbyplants{icon_state = "plant-21"},/turf/open/floor/iron/dark/side{dir = 4},/area/shuttle/escape)
"eC" = (/obj/structure/drain,/turf/open/floor/iron,/area/shuttle/escape)
"fd" = (/obj/effect/turf_decal/tile/blue,/turf/open/floor/iron/dark/side,/area/shuttle/escape)
"gH" = (/obj/effect/turf_decal/tile/neutral{dir = 1},/obj/effect/turf_decal/tile/neutral,/obj/effect/turf_decal/tile/neutral{dir = 4},/obj/effect/turf_decal/tile/neutral{dir = 8},/obj/machinery/light/small/directional/west,/turf/open/floor/iron,/area/shuttle/escape)
"iD" = (/obj/structure/chair/comfy/shuttle{dir = 4},/obj/effect/turf_decal/bot{color = "#FF0000"},/obj/structure/window/reinforced{dir = 1},/turf/open/floor/iron,/area/shuttle/escape)
"iL" = (/obj/machinery/door/poddoor/shutters/preopen,/obj/structure/lattice,/turf/open/floor/plating,/area/shuttle/escape)
"iU" = (/obj/structure/table,/obj/item/storage/firstaid,/obj/item/crowbar,/obj/effect/turf_decal/siding/wideplating/dark,/obj/effect/turf_decal/tile/blue,/obj/effect/turf_decal/tile/blue{dir = 8},/obj/effect/turf_decal/tile/blue{dir = 4},/turf/open/floor/iron,/area/shuttle/escape)
"iZ" = (/obj/structure/chair/comfy/shuttle{dir = 4},/obj/effect/turf_decal/bot{color = "#FF0000"},/turf/open/floor/iron,/area/shuttle/escape)
"kr" = (/obj/machinery/computer/emergency_shuttle{dir = 8},/obj/effect/turf_decal/tile/blue,/obj/effect/turf_decal/tile/blue{dir = 4},/obj/effect/turf_decal/tile/blue{dir = 8},/turf/open/floor/iron,/area/shuttle/escape)
"kM" = (/turf/open/floor/iron/dark/side{dir = 4},/area/shuttle/escape)
"lE" = (/turf/open/floor/iron/dark/side,/area/shuttle/escape)
"lJ" = (/obj/machinery/door/airlock/maintenance{name = "train access"},/obj/docking_port/mobile/emergency{dir = 2; name = "baluarte emergency shuttle"},/obj/effect/turf_decal/stripes/line,/obj/effect/turf_decal/stripes/line{dir = 1},/turf/open/floor/iron/dark/side{dir = 1},/area/shuttle/escape)
"lQ" = (/obj/effect/turf_decal/tile/neutral{dir = 1},/obj/effect/turf_decal/tile/neutral,/obj/effect/turf_decal/tile/neutral{dir = 4},/obj/effect/turf_decal/tile/neutral{dir = 8},/obj/machinery/light/small/directional/east,/turf/open/floor/iron,/area/shuttle/escape)
"mp" = (/obj/effect/turf_decal/siding/wideplating/dark/corner{dir = 1},/turf/open/floor/iron/dark/side{dir = 10},/area/shuttle/escape)
"mE" = (/obj/structure/chair/comfy/shuttle{dir = 4},/obj/effect/turf_decal/bot{color = "#FF0000"},/obj/structure/window/reinforced,/obj/machinery/light/small/directional/west,/turf/open/floor/iron,/area/shuttle/escape)
"mI" = (/obj/effect/turf_decal/siding/wideplating/dark{dir = 8},/obj/structure/chair/comfy/shuttle{dir = 4},/obj/effect/turf_decal/tile/blue{dir = 1},/obj/effect/turf_decal/tile/blue{dir = 8},/turf/open/floor/iron,/area/shuttle/escape)
"nb" = (/turf/closed/wall/r_wall,/area/shuttle/escape)
"nQ" = (/obj/machinery/door/poddoor/shutters/preopen,/obj/structure/lattice/catwalk,/turf/open/floor/iron/solarpanel,/area/shuttle/escape)
"pb" = (/obj/effect/turf_decal/tile/neutral{dir = 1},/obj/effect/turf_decal/tile/neutral,/obj/effect/turf_decal/tile/neutral{dir = 4},/obj/effect/turf_decal/tile/neutral{dir = 8},/turf/open/floor/iron,/area/shuttle/escape)
"qa" = (/obj/machinery/light/small/directional/south,/turf/open/floor/iron/dark/side{dir = 1},/area/shuttle/escape)
"qs" = (/obj/machinery/vending/wallmed/directional/north{use_power = 0},/turf/open/floor/iron/dark/side,/area/shuttle/escape)
"qV" = (/obj/structure/table/reinforced,/obj/machinery/cell_charger,/obj/effect/turf_decal/bot{color = "#FF0000"},/turf/open/floor/iron,/area/shuttle/escape)
"vW" = (/obj/structure/chair/comfy/shuttle{dir = 8},/obj/effect/turf_decal/bot{color = "#FF0000"},/obj/structure/window/reinforced,/obj/machinery/light/small/directional/east,/turf/open/floor/iron,/area/shuttle/escape)
"wO" = (/obj/structure/closet/wardrobe/mixed,/obj/effect/turf_decal/bot_red/left,/turf/open/floor/iron/dark/side{dir = 4},/area/shuttle/escape)
"wS" = (/obj/structure/chair/comfy/shuttle{dir = 8},/obj/effect/turf_decal/bot{color = "#FF0000"},/obj/structure/window/reinforced{dir = 1},/turf/open/floor/iron,/area/shuttle/escape)
"zH" = (/obj/structure/table,/obj/machinery/recharger,/obj/effect/turf_decal/siding/wideplating/dark{dir = 10},/obj/machinery/light/small/directional/west,/turf/open/floor/iron,/area/shuttle/escape)
"BU" = (/obj/structure/closet/wardrobe/mixed,/obj/effect/turf_decal/bot_red/left,/turf/open/floor/iron/dark/side{dir = 8},/area/shuttle/escape)
"De" = (/obj/effect/turf_decal/siding/wideplating/dark{dir = 1},/obj/effect/turf_decal/tile/blue{dir = 1},/obj/effect/turf_decal/tile/blue{dir = 4},/obj/effect/turf_decal/tile/blue,/turf/open/floor/iron,/area/shuttle/escape)
"GD" = (/obj/effect/turf_decal/siding/wideplating/dark,/obj/item/kirbyplants{icon_state = "plant-21"},/obj/structure/railing,/turf/open/floor/iron/dark/side{dir = 4},/area/shuttle/escape)
"GP" = (/turf/template_noop,/area/shuttle/escape)
"Hp" = (/obj/effect/turf_decal/tile/neutral{dir = 4},/obj/effect/turf_decal/tile/neutral,/obj/effect/turf_decal/tile/neutral{dir = 8},/obj/effect/turf_decal/tile/neutral{dir = 1},/obj/effect/turf_decal/siding/wideplating/dark,/turf/open/floor/iron,/area/shuttle/escape)
"Jq" = (/obj/effect/turf_decal/tile/neutral{dir = 1},/obj/effect/turf_decal/tile/neutral{dir = 4},/turf/open/floor/iron,/area/shuttle/escape)
"JY" = (/obj/structure/table/reinforced,/obj/item/storage/briefcase{pixel_x = 3; pixel_y = 3},/obj/item/storage/secure/briefcase,/obj/effect/turf_decal/bot{color = "#FF0000"},/turf/open/floor/iron,/area/shuttle/escape)
"Kj" = (/turf/open/floor/iron,/area/shuttle/escape)
"Lj" = (/turf/open/floor/iron/dark/side{dir = 1},/area/shuttle/escape)
"Lt" = (/obj/structure/flora/ausbushes/grassybush,/obj/structure/flora/ausbushes/lavendergrass,/obj/structure/flora/ausbushes/ywflowers,/obj/structure/flora/ausbushes/fernybush,/obj/structure/window/fulltile,/turf/open/floor/grass,/area/shuttle/escape)
"LO" = (/obj/machinery/door/airlock/maintenance{name = "train access"},/turf/open/floor/iron/solarpanel,/area/shuttle/escape)
"LY" = (/obj/structure/table/reinforced,/obj/item/storage/toolbox/emergency,/obj/effect/turf_decal/bot{color = "#FF0000"},/turf/open/floor/iron,/area/shuttle/escape)
"MM" = (/obj/effect/turf_decal/siding/wideplating/dark/corner{dir = 1},/obj/structure/railing/corner{dir = 1; pixel_y = -1},/turf/open/floor/iron/dark/side{dir = 8},/area/shuttle/escape)
"MP" = (/obj/effect/turf_decal/siding/wideplating/dark/corner{dir = 8},/turf/open/floor/iron/dark/side{dir = 9},/area/shuttle/escape)
"NE" = (/obj/structure/flora/ausbushes/grassybush,/obj/structure/flora/ausbushes/lavendergrass,/obj/structure/flora/ausbushes/ppflowers,/obj/structure/flora/ausbushes/sunnybush,/obj/structure/window/fulltile,/turf/open/floor/grass,/area/shuttle/escape)
"PR" = (/obj/effect/spawner/structure/window/reinforced,/turf/open/floor/iron/solarpanel,/area/shuttle/escape)
"QZ" = (/obj/machinery/light/small/directional/east,/turf/open/floor/iron/dark/side{dir = 8},/area/shuttle/escape)
"Sg" = (/obj/effect/turf_decal/tile/blue{dir = 4},/turf/open/floor/iron/dark/side{dir = 1},/area/shuttle/escape)
"TT" = (/obj/structure/chair/comfy/shuttle{dir = 8},/obj/effect/turf_decal/bot{color = "#FF0000"},/turf/open/floor/iron,/area/shuttle/escape)
"TY" = (/obj/effect/turf_decal/tile/neutral{dir = 4},/obj/effect/turf_decal/tile/neutral,/obj/effect/turf_decal/tile/neutral{dir = 1},/obj/effect/turf_decal/tile/neutral{dir = 8},/obj/effect/turf_decal/siding/wideplating/dark{dir = 1},/turf/open/floor/iron,/area/shuttle/escape)
"Uj" = (/obj/effect/turf_decal/tile/neutral{dir = 1},/obj/effect/turf_decal/tile/neutral,/obj/effect/turf_decal/tile/neutral{dir = 4},/obj/effect/turf_decal/tile/neutral{dir = 8},/obj/structure/extinguisher_cabinet/directional/east,/obj/machinery/light/small/directional/east,/turf/open/floor/iron,/area/shuttle/escape)
"UX" = (/obj/structure/chair/comfy/shuttle{dir = 8},/obj/effect/turf_decal/bot{color = "#FF0000"},/obj/machinery/light/small/directional/east,/turf/open/floor/iron,/area/shuttle/escape)
"VN" = (/obj/structure/chair/comfy/shuttle{dir = 4},/obj/effect/turf_decal/bot{color = "#FF0000"},/obj/machinery/light/small/directional/west,/turf/open/floor/iron,/area/shuttle/escape)
"XV" = (/obj/machinery/light/small/directional/north,/turf/open/floor/iron/dark/side,/area/shuttle/escape)
"Yd" = (/obj/effect/turf_decal/siding/wideplating/dark/corner{dir = 8},/obj/structure/railing/corner{dir = 8; pixel_y = 1},/turf/open/floor/iron/dark/side{dir = 8},/area/shuttle/escape)

(1,1,1) = {"
nblJnbnbnbnbnbPRPRPRnbPRPRPRnbGPGPGP
nbJqqVnbwOBUnbmEeCvWnbmEeCvWnbGPGPGP
PRKjUjnbkMQZnbiZKjTTnbiZKjTTnbnbnbnb
PRKjpbPRGDYdnbnbiLnbnbnbiLnbnbaGDePR
nbgHpbLOTYmpXVlElEcyXVqslEfdnQmIkrPR
nbgHpbLOHpMPqaLjLjLjqaLjLjSgnQbHbwnb
PRKjpbPRepMMnbnbiLnbnbnbiLnbnbzHiUPR
PRKjlQnbkMQZnbVNKjUXnbVNKjUXnbnbnbnb
nbJYLYnbLtNEnbiDeCwSnbiDeCwSnbGPGPGP
nbnbnbnbnbnbnbPRPRPRnbPRPRPRnbGPGPGP
"}
